 ** CANCION ** || ** ARTISTA/s **  LISTO + AGREGADO ++
Sudor y Trabajo - Duki + ++
The Endless Endeavor - Starset + ++
Someone New - Hozier + ++
Fujii Kaze - Shinunoga E-wa + ++
RICO POBRE - Julianno Sosa + ++
Llegará - Myke Towers + ++
RLNDT - Bad Bunny + ++
Goteo - Duki + ++
Necesario - Quevedo + ++
Pedro Dominguez Quevedo - Quevedo + ++
Otra Noche - Los Ángeles Azules, Nicki Nicole + ++
Noche - Van Gogh + ++
Tú Me Lo Haces Fácil - María Becerra + ++
Verano - Van Gogh + ++
Será que no me amas - Luis Miguel + ++
Paris - Van Gogh + ++
Looking Over Shoulders - Yumi Zouma + ++
Lying - PRETTYMUCH ft Lil Tjay + ++
Visions of Gideon - Susjan Steven + ++
Hasta que me olvides - Luis Miguel + ++
Ce Jeu - Yelle + ++
Un Ángel para Tu Soledad - Patricio Rey y sus Redonditos de Ricota + ++
Night Eyes - The Orion Experience + ++
Perdidamente - María Becerra + ++
Balada del Diablo y La Muerte - La Renga + ++
Antes de Perderte - Duki + ++
Ahora te puedes marchar - Luis Miguel + ++
NUDE - Kidd Keo + ++
José Sabía - La Vela Puerca + ++
Si Lo Puedes Soñar - Eladio Carrion + ++
Tengo 30 - Khea ft Duki, Cazzu, Neo Pistea, Tali Goya + ++

Ríos de Sal - Tiago PZK +
Magic Shop - BTS +
Sabor a Miel - Tiago PZK +
Black Swan - BTS +
cielo en la mente - Emilia +
Run - BTS +
Superstars - Kidd Keo +
The Astronaut - JIN +
Un piso más - YSY A +


Personalmente - Las Pelotas
Un día perfecto - Estelares
Razón - Caligaris
Cuando te enamores - Luciano Pereyra ft Antonio Jose
Na Na Na - Luck Ra
ACARAMELAO - Maria Becerra
Sold Out Dates - Duki
Ojitos Lindos - Bad Bunny, Bomba Estéreo
DNA. - Kendrick Lamar
BUENOS AIRES EN LLAMAS - Trueno
Rápido - Eladio Carrion, Jon Z, Noriel
Young Flex - Khea
Chico Estrella - Duki
Check - Anuel AA
Cheque - Eladio Carrion, Jon Z, Noriel
Leyenda - Anuel AA
MAMA - Kidd Keo
Mi Último Deseo - Banda Los Recoditos
Como Sea - Eladio Carrion, Arcangel
Dangerous - Nicki Nicole, Trueno, Bizarrap
Batman en Can Am - Arcangel
Michael X - Myke Towers
sherlock - oceanfromtheblue
midnight - offonoff
Slip - Elliot Moss
Estamos Bien - Bad Bunny
AIRDROP - Harry Nach, Duki
Trapicheo - Khea
EBISU - Kidd Keo
MORDIENDO EL BOZAL - YSY A, CLUB HATS, Yesan
chances - thuy
Mami Lo Siento - KHEA
She Don´t Give a Fo
Malbec - Duki, Bizarrap
What do you Think - Agust D
IMPALA - Nissa
Hidro - YSY A
Baby - Nicki Nicole
Shorty - Nicki Nicole, Duki
Ala delta - Divididos
Jijiji - Indio Solari
El Arriero - Atahualpa Yupanqui
Las calles Hablan - Gera MX, C-Kan, Jay Romero
Ateo - C. Tangana, NATHY PELUSO
De Vacaciones - FMK
Afuera Que Tengan Miedo - Gera MX
Shelby - Gera MX
Botella Tras Botella - Gera MX, Christian Nodal
Lento y Contento - Lua
Volando Remix - Mora, Bad Bunny, Sech
Rapsodia Bohemian - Queen
Y sin embargo - Sabina
Seguir viviendo sin tu amor - Spineta